NO textures/wolfenstein/grey_stone.xpm
SO textures/wolfenstein/grey_stone.xpm
WE textures/wolfenstein/grey_stone.xpm
EA textures/wolfenstein/grey_stone.xpm

F 113,113,113
C 56,56,56

                                                            
                                                            
                       11111111111111111                    
                       10000000000000001                    
     11111111111111111110000000000000001                    
     10000000000000000010000000000001111                    
     10000000000000000010000000000001                       
     10000000000000000020000000000001                       
     100000000000000000100000000000011111                   
     100000000000000000100000000000000001                   
     100000111111111111100000000000000001                   
     1000001           11111110000000000111111111           
     1000001                 10000000000200000001           
     1000001                 10000000000100000001           
     1000001                 10000000000111111111           
     1000001                 100000000001                   
     1000001           111111100001111111                   
     1112111           100000000001                         
       101             100000000001                         
       101             100000000001                         
       101             100000000001           111111111111  
       101             111111000001           100000000001  
       101                  1000001           100000000001  
       101                  1000001           100000000001  
       101           1111111111211111111      100000000001  
       101           1000000000000000001111111111100000001  
       101           1000000000000000001000000000100000001  
       101           1000000000000000002000000000200000001  
       101           1111111000000010001000000000100000001  
       101           1000001000000010001111100111100000001  
       101           1000002000000010001   100100100000001  
       101           1000001000000010001   100100111211111  
  1111112111111      1111111000000010001   100100000001     
  1000000000001      1000000000000010001   100100000001     
  1000000000001      1111111111211111111   100100000001     
  1000000000001              10001         100200000001     
  1000000000001              10001         100100000001     
  1000000000001              10001         111111111111     
  1000000000001              10001                          
  1000000000001              10001                          
  1000000000001              10001                          
  10000000000011111111       10001                          
  10000000000020000001       10001                          
  10000000000011111001       10001                          
  1111111211111   1001       10001                          
       100001     1001       10001                          
       100001     1001   1111112111111                      
       100001     1001   1000000000001                      
       100001     1001   1000000000001                      
       111111     1001   1000000000001                      
                  1001   1000000000001                      
                  1111   1000000000001                      
                         1000000000001                      
                         1000000000001                      
                         1000000000001                      
                         1000000000001                      
                         1000000000001                      
                         100000N000001                      
                         1000000000001                      
                         1111111111111                      

